C 196,156,63

WE ./textures/cheese_museum.xpm
EA ./textures/cheese_museum2.xpm
NO ./textures/cheese_art.xpm
SO ./textures/toilet_door.xpm

F 220,210,185

11111111111111
10000000000001
10000000000001
10000000000001
10000000000001
100000000000N1
11111111111111
