
EA             ./path_to_the_east_texture
NO ./path_to_the_north_texture

C 225,30,0

WE ./path_to_the_west_texture

SO ./path_to_the_south_texture

F 220,100,0


1111111111111111111111111111111
1000000000110000000000001
1011000001110000000000001
100100000000000000000000111111111
111111111011000001110000000000001
100000000011000001110111111111111
111101111111110111000000100011
11110111111111111010100100011
110000001101010111000000100001
10000000000000001100000010001
1000000000000000110101001001
11000001110101011111011110E0111
111101111110101101111010001
11111111 1111111111 1111111
