C 196,156,63

WE ./textures/draw_cheese.xpm
EA ./textures/blue.xpm
NO ./textures/cheddar.xpm
SO ./textures/mouse_cheese.xpm

F 220,210,185

11111111111111
10000000000001
10000000000001
100000N0000001
10000000000001
10000000000001
11111111111111
