EA ./path_to_the_east_texture
NO ./path_to_the_north_texture

C 225,30,0

WE ./path_to_the_west_texture

SO ./path_to_the_so_texture

F 100,0,65

1111111111111111111111111111111
1000000000110000000000001
1011000001110000000000001
100100000000000000000000111111111
111111111011000001110000000000001
100000000011000001110111111111111
111101111111110111000000100011
111101111111111110101001000001
1100000011010101110000001000011
10000000000000001100000010001
1000000000000000110101001S01
1100000111010101111101111001111
111101111110101101111010001
11111111 1111111111 1111111
