WE ./textures/cheese_museum.xpm
EA ./textures/cheese_museum2.xpm
NO ./textures/cheese_art.xpm
SO ./textures/toilet_door.xpm

F 0,0,185
C 196,156,63

11111111
1N000001
11111111
